....................
....................
....................
....................
....................
....................
....................
....................
....................
....................
.............-......
.........-...-......
.........-...-......
1........-...-....X.
####################
