....................
....................
....................
....................
....................
....................
....................
....................
....................
....................
............++......
....++......++......
....++...#..++......
1...++...#........X.
####################
