....................
....................
....................
....................
....................
....................
....................
....................
....................
.........+-.........
.........+-.........
.........+-.........
......##....##......
1.................X.
######~~~~~~~~######
