....................
....................
....................
....................
....................
....................
....................
...........#########
....................
...........--..FF...
...........--..++...
.......+..###.......
.......+.##.........
.1.....+###.......X.
###########~~~~~~###
