....................
....................
....................
....................
....................
....................
.............X......
............###.....
....................
.................###
.....F..............
.....F...::..###....
.....:...::.........
.1.......::.........
####################
