....................
....................
....................
.............###.+-.
.................+#.
.................##.
....####........###.
.X..................
###.........###.....
....................
........###.........
....................
....###.............
.1..................
#######~~~~~~~~~~~~~
