....................
....................
................F###
...........-....F...
........###-###.F...
...........-.#..F...
..#####....-.#..F...
.......##..-.#..-...
...........-...#....
.......F...-......X.
.......+..#......###
.......+............
....###.............
.1..............#...
####################
