....................
....................
...F.....F.....F#...
...F....FF....FF#.X.
...F....++....FF#FF.
...+.F........-+.:-.
..-:-F....###.......
##...F..............
...-.+..............
.....+.###......#...
.....:..........#...
.....-..........#...
..##.-..........#...
.1##.-........###...
######~~~~~~~~######
