....................
....................
.F....F....##F....#.
.F...F+.....#F#...#.
.FF..-+.....+-....#.
.FF..-......F....##.
.+FF.....##.FF...##.
.+-F#....#..FF..#...
..-+.FF..#..++..#+..
...+.FF..#..+...#+..
....F-+..#......#+.#
....+-...#.#....#.#.
....+....#.#.#..#...
.1.......#.#.#..#.X.
#######~~#~###~~####
