....................
.........F..........
........#F#...+....F
..F.....#+....F....+
..FF.##.#F....F#...F
..:F..#X#+..FFF....:
..F+#.###F..+:+....:
.#-F.....F..#:F.-...
..-:.....-...F+.....
......##.....-.....-
...................#
................#...
...........F........
.1#........-##......
##~~~~~#~~~~~~~~~~~~